11111111111111111
10C100000C100C1C1
10100111111011101
10100000001000101
100011EP000110101
1C100C10000000001
11111111111111111
