1111111111111
10010000000C1
1CC0011111001
100011EP00001
1111111111111
