1111111111111111111111
1000000000000000000001
101001010010E000101001
1010010010100010001001
1P0000000C000000000001
1111111111111111111111
