1111111111111
1001000000PC1
10C0011111001
100011E000001
1111111111111